Station data is corrupted. Please rebuild the station!=站点数据已损坏。请重建车站！
Station is still blocked. Please try again in a few seconds!=车站仍被封锁。请稍后再试！
Additional station information=附加电台信息
Hyperloop Booking Machine=超级高铁订票机
Invalid station name!=站名无效！
Please enter the station name to@nwhich this booking machine belongs.=请输入站名致@nwhich这台订票机属于。
Station has already a booking machine!=车站已经有一台订票机了！
Station name=车站名称
Select your destination=选择您的目的地
<unknown>=<未知>
Hyperloop Promo Poster =Hyperloop促销海报
Hyperloop Station Sign=超级高铁站标志
Hyperloop Station Sign Left=超级高铁站左标志
Hyperloop Station Sign Right=右超级高铁线车站标志
Hyperloop Door Bottom=Hyperloop门底
Hyperloop Door Top=Hyperloop门套
The Booking Machine for this station is missing!=这个车站的订票机不见了！
(current position)=（当前位置）
Base=基地
Destination=目的地
Floor=地板
Floor name=楼层名称
Hyperloop Elevator=超级高铁行电梯
Hyperloop Elevator Shaft=超级高铁行电梯井
Please insert floor name=请插入楼层名称
Save=保存
Hyperloop Junction Block=超级高铁型接线盒
Hyperloop Pillar=超级高铁带支柱
Junction connected with =连接
Station connected with =连接的站点
Junction=接合
Hyperloop Display=超级高铁显示屏
 |  | << Hyperloop >> | be anywhere=|  | << 超级高铁 >>|随时随地
Close=关闭
Conn. with=连接
Dist.=距离。
Hyperloop Station Book=超级高铁线站点列表
Owner=所有者
Position=位置
Station/Junction=车站/路口
Hyperloop Legacy Tube=超级高铁传统管
unknown=未知的
Hypersteel Ingot=高铁钢锭
 | Welcome at | | =| 欢迎光临 ||
Arrival in:=到达时间：
Destination:=目的地：
Distance:=距离：
Hyperloop Pod Seat=Hyperloop吊舱座椅
Thank you | for | travelling | with | Hyperloop.=感谢您乘坐Hyperloop旅行。
[Hyperloop] No booking entered!=[Hyperloop]没有预订！
Area is protected!=区域受到保护！
Blue Wool=蓝色羊毛
Build Station=建立站点
Destroy Station=摧毁站点
Glass=玻璃
Hyperloop Pod Shell=超级高铁吊舱外壳
Hyperloop Station Block=超级高铁车站方块
Hyperloop Station Pod Builder=超级高铁吊舱建造者
Not enough inventory items to build the station!=没有足够的库存物品来建造车站！
Not enough space to build the station!=没有足够的空间建造车站！
Station=车站
Station completed. Now place the Booking Machine!=车站已完工。现在把订票机放好！
Do you really want to start a new network?!=你真的想建立一个新的网络吗？！
Hyperloop Tube=超级高铁行管
Junction at =交叉口
Open end at =开口端在
Station '=车站'
Station at =车站
There is no station/junction on this level. =这一层没有车站/交叉口。
    left: remove node@n=左：移除节点@n
    right: repair tube/shaft line@n=右：维修管/轴线@n
Hyperloop Tube Crowbar=高铁管子撬棍
Repair via WorldEdit placed Hyperloop tubes by reusing WorldEdit pos1/pos2=通过重用WorldEdit pos1/pos2通过WorldEdit放置的超循环管进行修复
Rights to remove tube nodes by means of the crowbar=使用撬棍移除管节点的权限
You don't have the necessary privs!=你没有必要的权限！
[Crowbar Help]@n=【撬棍帮助】@n
Hyperloop Waypoint=超级高铁航线路点
Enter channel string=输入通道字符串
Hyperloop WiFi Tube=Hyperloop WiFi管
